----------------------------------------------------------------------------------------------------
-----1--1----------------------------------------------------------------------------------1--1-----
----------------------------------------------------------------------------------------------------
----------------------------------------------------------------------------------------------------
----------------------------------------------------------------------------------------------------
-4------------1---1---1---1---1---1---1---1---1---1---1---1---1---1---1---1---1---1---1-----------2-
-----z-----------------9----------------9-------------------9-----------------------------cccccc----
------------------------------------------------------------------------------------------cccccc----
-4-----------3---3---3---3---3---3---3---3-!-3---3---3---3---3---3---3---3---3---3---3------------2-
--------------------------------1--1--1--1---1--1--1--1---------------------------------------------
-------------------------------------------p--------------------------------------------------------
-------------------------------4-------------------------2------------------------------------------
----------------------------------------------------------------------------------------------------
-----4--2----------------------------------------------------------------------------------4--2-----
----------1--1----------------4-------------------------2-------------------------------------------
---------------2-----------------------------------------------1--1--1----1--1--1-------------------
-------9--3-----------------------------------------------------------------------------------------
-----4--2---4--2--------------4-------------------------2----4---------24---------2--------4--2-----
----------------------------------------------------------------------------------------------------
------------4----1--1--1--1--1----------------------------------------------------------------------
--------------------------------------------------------2----4--------------------2-----------------
-----4--2-----3--3--3--3--3--3--3--3--3--3-7-3--3--3--3------------------------------------4--2-----
-------------------------------------------------------------------------------------------------------------
-------------------------------------------------------------4---------24---------2-------------1---1---1----
------------------------------------------------------------------------------------------------------------2
-----4--2--------------------------1------1------1-----1--1----3-----3----3-----3----------4-----------------
-------------------4----2--------------------------------------1--<--1----1-----1---------------3------------
--------------------------------4------------24-------------2------------------------------------------------
------------------------------------3----3--------3----3-----4---------24---------2----------------4--------2
-----4--2----------4---------1------1----1--------1----1-----------------------------------4--2--------------
-------------------------------------------------------------------------------------------------------------
-----------------------------------------------------------------------24------------------------------------
---------------------------------------------------------------------------------------------------4--------2
-----4--2---------------3--3--3-----3----3--------3----3-----------------------------------4--2--------------
------------------------------------1----1--------1----1-----4---------24---------2--------------------------
--------------------------------4--------c---24-------------2------------------------------------------------
------------------------------------------------c---------------3--3--3----3---------------------1----------2
-----4--2--------------------------3------3------3-----3--3--------------------------------4-----------------
-----------------------1---1---1---1---1---1---1---1---1---1---1---1---1----------2--------------------------
------------------------------------------------------------------------------------------------3------------
---------------------------------------------------------------------------------------------------4--------2
-----4--2----------------------------------------------------------------------------------4--2--------------
-------------------------------3---3---3---3---3---3---3---3---3---3---3---3---3-----------------------------
-----------------4-------------------------------------------------------------------------------------------
---------------------------------------------------------------------------------------------------4--------2
-----4--2-----------------------------------------------------------------------1---1---1-----2--------------
-----------------4-----------------------------------------------------------------------------------------c-
------------------------1---1---1---151---1---1---1---1---1---1---1---1---1--------------------------3----3--
------------------------------------------------------------------------------------3---3--------------------
-----4--2--------4----4-----------------------------4--------------------------------------4--2-----
----------------------------------------------------------------------------------2-----------------
----------------------------------------------------------9-----------------------------------------
-----------------4----4-----------------------------4-----------------------------2-----------------
-----4--2-------------------------------------------------3---3---3---3---3---3------------4--2-----
-----------------8----8-----------------------------8-----------------------------------------------
-----------------8----8-----------------------------89----------------------------------------------
-------9--------------------------------------------------1---1---1---1---1---1---------------------
-----4--2--------4----4-----------------------------4-----------------------------2--------4--2-----
----------------------------------------------------------------------------------------------------
----------------------------------------------------------------------------------2-----------------
-----------------4----4-----------------------------4-----------------------------------------------
-----4--2---------------------------------------------------------------------------1---1-----2-----
------------------------3---3---3---3---3---3---------3---3---3---3---3---3-------------------------
-----------------4----------------------------------------------------------------------------------
-----------------------------------------------4----2---------------------------3---3---3-----------
-----4--2-------------------1---1---1---1---1-----------1---1---1---1---1---1---1----------4--2-----
----------------------------------------------------------------------------------------------------
-----4--2---------------------------9------------------------------------------------------4--2-----
-----------------------------------------------------------------------------------2----------------
--------------------3---3---3---3---3---3---3---3---3---3---3---3---3---3---3-----------------------
----------------------------------------------------------------------------------------------------
------------------------------------------------------------------------------4----2----------------
-4------------1---1---1---1---1---1---1---1---1---1---1---1---1---1---1---1-----------1-----------2-
--------------------------------------------------------------------------------------------z-------
------9-----------------------------------------------------------------------------------9---------
-4------------3---3---3---3---3---3---3---3---3---3---3---3---3---3---3---3---3---3---3-----------2-
----------------------------------------------------------------------------------------------------
----------------------------------------------------------------------------------------------------
----------------------------------------------------------------------------------------------------
-----3--3----------------------------------------------------------------------------------3--3-----
----------------------------------------------------------------------------------------------------
