b 0 1
s 1 1
1 2 1
2 3 1
3 4 1
4 5 1
5 6 1
6 7 1
7 8 1
8 9 1
9 10 1
! 11 1 1
@ 12 1 1
# 13 1 1
$ 14 1 1
% 15 1 1
^ 16 1 1
& 17 1 1
* 18 1 1
` 19 1 1
~ 20 1 1
( 21 1 1
) 22 1 1
- 23 1 1
_ 24 1 1
+ 25 1 1
= 26 1 1
0 27 1 1
{ 28 1 1
} 29 1 1
[ 30 1 1
] 31 1 1
; 32 1 1
: 33 1 1
' 34 1 1
" 35 1 1
, 12 1 1
< 15 1 1
. 17 1 1
> 14 1 1
q 12 1 1
w 15 1 1
e 17 1 1
r 14 1 1
t 20 1 1
y 23 1 1
u 25 1 1
i 22 1 1
\ 68 1
| 69 1
/ 70 1
? 71 1