------------------------------------------------------------------------------------------------------------------------
----1--151--1--151--1--151--1-5-1--151--1--151--1--151--1------1--151--1--151--1--151--1-5-1--151--1--151--1--151--1----
------------------------------------------------------------------------------------------------------------------------
-4--------------------------------------------------------2--4--------------------------------------------------------2-
-8--------------------------------------------------------6--8--------------------------------------------------------6-
-4--------------------------------------------------------2--4--------------------------------------------------------2-
------------------------------------------------------------------------------------------------------------------------
-4--------1--151--1--151--1--55--1--151--1--151--1--------2--4--------1--151--1--151--1--55--1--151--1--151--1--------6-
-8----2----------------------------------------------4----6--8----2----------------------------------------------4----2-
-4-----4--------------------------------------------2-----2--4-----4--------------------------------------------2-----6-
--z--z------------------------------------------------z--z----z--z------------------------------------------------z--z--
-4----24--------------------------------------------24----2--4----24--------------------------------------------24----2-
-8--------------------------------------------------------6--8--------------------------------------------------------6-
-4----24--------------------------------------------24----2--4----24--------------------------------------------24----2-
------------------------------------------------------------------------------------------------------------------------
-4----24--------------------------------------------24----2--4----24--------------------------------------------24----2-
-8--------------------------------------------------------6--8-----------4--------------------------------------------6-
-4--------------------------------------------------24----2--4----24--------------------------------------------z-----2-
----------------------------------------------------------------------------3---3---3---3---3---3-----------------------
-----------------------------------------------------4----2--4----24---------------------------2--4---------------------
----3---3---3---3---3---3--------3---3---3---3---3--------6--8---------------------------------6-----3---3--7--3---3----
-----------------------------------------------------4----2--4----24---------------------------2------------------------
----------------------------------------------------------------------3--3--3--3--3--3--3-------------------------------
----1---1---1---1---1---1-----------------1--1--1--1------2--4------1---1--1551--1---1-----4-----1---1---151---1---1----
----------------------------z--z2-------------------------6--8----------------------------------------------------------
---------------------------------------4------------------2--4--------------------------2--4--------------------------2-
-4------------------------------2---------------------------------------------------------------------------------------
-8-------------------------------------4------------------2--4--------------------------2--4--------------------------2-
-8------------------------------2-------------------------6--8----------------------------------------------------------
-4-------------------------------------4------------------2--4--------------------------2--4--------------------------2-
--------------------------------2---------------------------------------------------------------------------------------
---------------------------------------4---------------------4--------------------------2--4--------------------------2-
--!--3---3---3---3---3---3---3----------------3---3---3-----------------------------------------------------------------
-----1---1---1-------------------------4----2-------------------3---3--3773--3---3------2--4--------------------------2-
------------------------------------------------------------------------------------------------------------------------
-4p------------2-----------------------4----2--------------------------------------4----2--4--------------------------2-
------------------------------------------------------------------------------------------------------------------------
-4-------------2-----------------------4------1---1---1---1---1---1---1---1---1---1-----2-----------------------------2-
------------------------------------------------------------------------------------------------------------------------
-4-------------2-----------------------4------------------------------------------------2-----------------------------2-
------------------------------------------3---3---3---3---3---3---3---3---3---3---3---3-------3---3--3773--3---3--------
-4-------------2-------------------------------------------------------------------------------------------------4----2-
------------------------------------------------------------------------------------------------------------------------
-4-------------2-------------------------------------------------------------------------------------------------4----2-
---------9--------------------------------------------------------------------------------------------------------------
---3--3--3--3--2----------1---1---1---1---1---1---1------------------1---1---1---1---1---1---1-------------------4----2-
------------------------------------------------------------------------------------------------------------------------
---------------2--------------------------------------------------------------------------------------------------------
---1--1--1--1-----------------------------------------------------------------------------------------------------------
-4-------------2--------------------------------------------------------------------------------------------------------
------------------------------------------------------------------------------------------------------------------------
-4--------z----2--------------------------------------------------------------------------------------------------------
-------3--3--3----------------------------------------------------------------------------------------------------------
-4-----1--1--1----4-----------------2---4-----------------2--4-----------------2---4-----------------2------------------
------------------------------------------------------------------------------------------------------------------------
-4-------------2--4-----------------2---4-----------------2--4-----------------2---4-----------------2------------------
------------------------------------------------------------------------------------------------------------------------
-4-------------2--4-----------------2---4-----------------2--4-----------------2---4-----------------2------------------
------------------------------------------------------------------------------------------------------------------------
-4-------------2--4-----------------2---4-----------------2--4-----------------2---4-----------------2------------------
------------------------------------------------------------------------------------------------------------------------
-4-------------2--4-----------------2---4-----------------2--4-----------------2---4-----------------2------------------
--------------------------------------------------------------------------------------------------------1---1---1---1---
-4----------------------------------------------------------------------------------------------------------------------
----------------------------------------------------------------------------------------------------------------------2-
------------------------------------------------------------------------------------------------------------------------
---3---3---3---3---3---3---3---3-------------3---3---3---3-77-3---3---3---3-------------3---3---3---3---3---3---3-----2-
------------------------------------------------------------------------------------------------------------------------
-4--------------------------------------------------------------------------------------------------------------------2-
-8--------------------------------------------------------------------------------------------------------------------6-
-4--------------------------------------------------------------------------------------------------------------------2-
------3--c---3---3---3---3---3---3---3---3---3---3----c--3-77-3--c----3---3---3---3---3---3---3---3---3---3---c--3------
-4-------c---1---1---1---1-----------1---1---1---1----c----------c----1---1---1---1-----------1---1---1---1---c-------2-
-8---2--4--------------------2----4--------------------2--------4--------------------2----4--------------------2--4---6-
-4--------------------------------------------------------------------------------------------------------------------2-
--------4--------------------2----4--------------------2--------4--------------------2----4--------------------2--------
-4--------------------------------------------------------------------------------------------------------------------2-
-8---2--4--------------------2----4--------------------2--------4--------------------2----4--------------------2--4---6-
-4--------------------------------------------------------------------------------------------------------------------2-
--------4--------------------2----4--------------------2--------4--------------------2----4--------------------2--------
-4--------------------------------------------------------------------------------------------------------------------2-
-8---2--4--------------------2----4--------------------2--------4--------------------2----4--------------------2--4---6-
-4---------3--3--3--3--3--3----------3--3--3--3--3--3--------------3--3--3--3--3--3----------3--3--3--3--3--3---------2-
------------------------------------------------------------------------------------------------------------------------
-4--------------------------------------------------------------------------------------------------------------------2-
-8---2-----1--1--1--1--1--1----------1--1--1--1--1--1--------------1--1--1--1--1--1----------1--1--1--1--1--1-----4---6-
-4------4--------------------2----4--------------------2--------4--------------------2----4--------------------2------2-
------------------------------------------------------------------------------------------------------------------------
-4------4--------------------2----4--------------------2--------4--------------------2----4--------------------2------2-
-8---2--------9---------------------------9---------------------------9--------------------------9----------------4---6-
-4------4--------------------2----4--------------------2--------4--------------------2----4--------------------2------2-
------------------------------------------------------------------------------------------------------------------------
-4------4--------------------2----4--------------------2--------4--------------------2----4--------------------2------2-
-8---2------------------------------------------------------------------------------------------------------------4---6-
-4------4--------------------2----4--------------------2--------4--------------------2----4--------------------2------2-
-------------3---3---3---3-----------3---3---3---3--------------------3---3---3---3-----------3---3---3---3-------------
-4----1------1---1---1---1---1---1---1---1---1---1-------1-55-1-------1---1---1---1---1---1---1---1---1---1------1----2-
-8--------------------------------------------------------------------------------------------------------------------6-
-4--------------------------------------------------------------------------------------------------------------------2-
------------------------------------------------------------------------------------------------------------------------
------------------------------------------------------------------------------------------------------------------------
----373--373--373--373--373--373--373--373--373--373--373-3773-373--373--373--373--373--373--373--373--373--373--373----
------------------------------------------------------------------------------------------------------------------------
