------------------------------------------------------------------------------------------------------------------------
-----------------------------------------1---1---1---1---1-55-1---1---1---1---1-----------------------------------------
------------------------------------------------------------------------------------------------------------------------
---------------------------------------8----------------------------------------6---------------------------------------
---------------------------------------4----------------------------------------2---------------------------------------
---------------------------------------8----------------------------------------6---------------------------------------
------------------------------------------------------------------------------------------------------------------------
------------------------------------------------------------------------------------------------------------------------
---151--1---1---1---1---1---1---1---1----------------------------------------------1---1---1---1---1---1---1---1--151---
------------------------------------------------------------------------------------------------------------------------
-4--------------------------------------------------------------------------------------------------------------------2-
------------------------------------------------------------------------------------------------------------------------
-4--------------------------------------------------------------------------------------------------------------------2-
-8--------------------------------------------------------------------------------------------------------------------6-
-4---------3---3---3---3----3---3---3----------------------------------------------3---3---33---3---3---3---3---------2-
------------------------------------------------------------------------------------------------------------------------
-4-------------------------------------8----------------------------------------6-------------------------------------2-
---------------------------------------4----------------------------------------2---------------------------------------
-4-----2-------------------------------8----------------------------------------6-------------------------------4-----2-
-8-----6--------------------------------------------------------------------------------------------------------8-----6-
-4-----2-----------------------------------3---3--3------------------3------3-----------------------------------4-----2-
------------------------------------------------------------------------------------------------------------------------
-4--------------------------------------------------------------------------------------------------------------------2-
-----------1----1----1----1----1----------------------4----------2----------------------1----1----1----1----1-----------
-4--------------------------------------------------------------------------------------------------------------------2-
-8----------------------------------2----------------------------------------------4----------------------------------6-
-4----------------------------------6-----------------4----------2-----------------8----------------------------------2-
------------------------------------6----------------------------------------------8------------------------------------
-4----------------------------------2----------------------------------------------4----------------------------------2-
------------------------------------------------------4----------2------------------------------------------------------
------3----3----3----3----3----3--------------------------------------------------------3----3----3----3----3----3------
------------------------------------------------------------------------------------------------------------------------
------------------------------------------------------4----------2------------------------------------------------------
------------------------------------------------------------------------------------------------------------------------
------------------------------------------------------------------------------------------------------------------------
------------------------------------------------------4----------2------------------------------------------------------
------------------------------------------------------------------------------------------------------------------------
-------------1---1---1---1---1---1---1---1---1---1---1------------1---1---1---1---1---1---1---1---1---1---1-------------
---------4----------------------------------------------------------------------------------------------------2---------
---------8----------------------------------------------------------------------------------------------------6---------
---------4-----------------------------------------3---3--3773--3---3-----------------------------------------2---------
-----------------------------------------------2------------------------4-----------------------------------------------
-----------3---3---3---3---3---3---3---3-------6------------------------8-------3---3---3---3---3---3---3---3-----------
-----------1---1---1---1---1---1---1---1--c----6------------------------8----c--1---1---1---1---1---1---1---1-----------
-------------------c-------------------c-------2------------------------4-------c-------------------c-------------------
---------4-------------------c-----------c------------------------------------c-----------c-------------------2---------
---------8-------3---3---3---3---3---3---3---3----------------------------3---3---3---3---3---3---3---3-------6---------
---------8-------1---1---1---1---1---1---1---1----------------------------1---1---1---1---1---1---1---1-------6---------
---------4---------------c--------------------------------------------------------------------c---------------2---------
---------------c-------------------c-----------2------------------------4-----------c-------------------c---------------
-----------3---3---3---3---3---3---3---3---c---6------------------------8---c---3---3---3---3---3---3---3---3-----------
-----------1---1---1---1---1---1---1---1-------6------------------------8-------1---1---1---1---1---1---1---1-----------
---------------------------c-----------c-------2------------------------4-------c-----------c---------------------------
---------4-------c---------------c----------------------------------------------------c---------------c-------2---------
---------8-------3---3---3---3---3---3---3---3----------------------------3---3---3---3---3---3---3---3-------6---------
---------8-------1---1---1---1---1---1---1---1----------------------------1---1---1---1---1---1---1---1-------6---------
---------4------c----------------c----------------------------------------------------c----------------c------2---------
-----------------------c------------------c----2------------------------4----c------------------c-----------------------
-----------3---3---3---3---3---3---3---3----------------------------------------3---3---3---3---3---3---3---3-----------
------------------------------------------------------------------------------------------------------------------------
-----------------------------------------4------------------------------------2-----------------------------------------
-----------------------------------------------2------------------------4-----------------------------------------------
------------------------------------------------------------------------------------------------------------------------
---------------------------------------------------1---1--1551--1---1---------------------------------------------------
--------1---1---1---1---1---1---1--------4------------------------------------2--------1---1---1---1---1---1---1--------
------9----------------------------------------------------------------------------------------------------------9------
-----4----------------------------2--------------------------------------------------4----------------------------2-----
------------------------------------------------------------------------------------------------------------------------
-----8-----------------------------------4------------------------------------2-----------------------------------6-----
-----8------------------------------------------------------------------------------------------------------------6-----
----------------------------------2--------------------------------------------------4----------------------------------
-----4------------------------------------------------------------------------------------------------------------2-----
------------------------------------1--1----------------------------------------1--1------------------------------------
------------------------------!---p---------------------------------------------@-----q---------------------------------
--------3---3---3---3---3---3---3---3--3----------------------------------------3--3---3---3---3---3---3---3---3--------
------------------------------------------------------------------------------------------------------------------------
-----------------------------------------4------------------------------------2-----------------------------------------
------------------------------------------------------------------------------------------------------------------------
----1---1---1---1---1---1---1---1---1---1--------------------------------------1---1---1---1---1---1---1---1---1---1----
-4--------------------------------------------------------------------------------------------------------------------2-
-8--------------------------------------------------------------------------------------------------------------------6-
-4--------------------------------------------------------------------------------------------------------------------2-
--------3---3---3---3---3---3---3---3---3---3---3---3---3--77--3---3---3---3---3---3---3---3---3---3---3---3---3--------
-4---2------------------------------------------------------------------------------------------------------------4---2-
------------------------------------------------------------------------------------------------------------------------
------------------------------------------------------------------------------------------------------------------------
-4---2-------1---1---1---1---1---1---1---------1---1---1---55---1---1---1---------1---1---1---1---1---1---1-------4---2-
----------4-----------------------------2----4----------------------------2----4-----------------------------2----------
-----------------------------------------1--1------------------------------1--1-----------------------------------------
-4--------------------------------------------------------------------------------------------------------------------2-
------------------------------------------------------------------------------------------------------------------------
--373---3--------------------------------3--3------------------------------3--3--------------------------------3---373--
----------4-----------------------------2----4----------------------------2----4-----------------------------2----------
-------------3---3---3---3---3---3---3---------3---3---3---77---3---3---3---------3---3---3---3---3---3---3-------------
------------------------------------------------------------------------------------------------------------------------
------------------------------------------------------------------------------------------------------------------------